20 19
|-----------------|
|.....F..|..F.....|
|P--.---.|.---.--P|
|.................|
|.--.|.-----.|.--.|
|....|...|...|....|
|---.|.......|.---|
|......-.F.-......|
|......|FFF|......|
|......-----......|
|---.|.......|.---|
|....|.-----.|....|
|........|........|
|.--.---.|.---.--.|
|P.|.....@.....|.P|
|-.|.|.-----.|.|..|
|....|...|...|....|
|.------.|.------.|
|..F...........F..|
|-----------------|