7 17
|---------------|
|..|...|...-..|.|
|..-|.@..|..-...|
|...............|
|...-.-...--..-.|
|...|.|...|...|.|
|---------------|