7 17
|---------------|
|..|...|...-..|.|
|..-|.@..|..-...|
|...........F...|
|F..-.-...--..-.|
|...|.|...|...|.|
|---------------|